O0O0O0O0O0O0O0O0O0O0O0O0O0O0O0O0O0O0O0O0
O0O0O0O0C5C5C5C5C6O1O1O1O1O1O1C3C3C3C4O0
O0O0O0C2C5O2C5C5C6O1O1O1O1O1O1C5C3C3C4O0
O0O0C2C2C5O2C5C5C6B1O1O1O1O1B1C2C4C4E8O0
O0C2C2C2C2C2C5C5C3C3C3C3C3C3B1B4B0B0B0O0
O0C6C6C6C6C2C2C5O2C4C3C3C3C3C2C2C5C5C4O0
O0C6C6C6C6C2C2C3C4C4C3C3C3C2C2E4C2C2C4O0
O0O0C6C6C6C2C2C2E6C4C4C4C2C2C2R3C2C2C2O0
O0O0O0C6C6C2C2C2C4C4C4C4C4C2C2C2C2C2C5O0
O0O0O0O0C6C6B1B1C4C4C4C4C4C4E2C2C5C5C5O0
O0O0O0C6C6C6B1S3R0C4C4C4R0C4C4D1C3C4C5O0
O0O0C6C6C6C6B1B1C4C4C4C4C4C4C4C3C4C4C5O0
O0C6C6C6C6C6C5C5C5C4O2C4C4C4C4C3E1E3C5O0
O0C6C6C6C6C5C5C5C5C5C5C5C4C4C3C3C4C4O2O0
O0C6C6C6C6C5C5C5C5C5C5C5C3C4C4C3C4C4C5O0
O0C6C6C6C5C5C5C5B1C5C5C4C4C4C4C3C4C4C5O0
O0O0C6C5C5C5C5B0E9B1O1O1O1O1B1C2D2C5O0O0
O0O0O0C5C5C5C5C5B1O1O1O1O1O1O1B1C4O0O0O0
O0O0O0O0C5C5C5C5B0O1O1O1O1O1O1O1O0O0O0O0
O0O0O0O0O0O0O0O0O0O0O0O0O0O0O0O0O0O0O0O0
