O2O2O2O2O2O2O2O2O2C5C5O2O2O2O2O2O2O2O2O2
O2O2C5C5C5C5C5C5C5C5C5C5C5O1O1O1O1O1O1O2
O2C5C5C5C3C5C5C5C3C9C3E8B3C5C5C5C5R3O1O2
O2C5O1C5C3O2O1O2O1C3C3O1O1C5O1O1C5C5O1O2
O2C5O3C2D1C5C1B1C3C3C3C3C3C5C5C2O1C5O3O2
O2C5D2C3C3C3D5C3C3C3C4C3C3R1C5C5O1C8O3O2
O2C5C3E7C3S1C3C3D6C3C3C3C3R3C5C5O1C5O3O2
O2C5C3C3C3D4O1O1C3C3E9O2C3C3C5C5R1R3O3O2
O2C5E5D3C6D8C3C3C2O1C3O2O2C6C6C3C7C5C5O2
C5C5C3C3C3C6C3D7C3O1C3C3C3C6C3C3C3C5C5C5
C5C5C3C3C4C6R3C7C4C3C3C3C4C6R1O1C3C4C4C5
O2C5C3C3C4C6C4C3O3O1C3O3C4C6C4O1C3C5C4O2
O2C5C3C3C4O1C4C3O3O1C3O3C4O1C4C3C3C5C4O2
O2C5C3C3C4C4C3C3O0C3C3O0C4C4C4C3C3C5C4O2
O2C5C3C7C7E3C3C3O0C3C3O0C3C3C3C7C7C5C5O2
O2C5C5C2C7C3C2C6C3C3C3C3E4C3C3C7C2O1C5O2
O2O1C5C3C3R1C3C3C3C3C3C3C3C3C3C3O1O1C5O2
O2O1C5C5C5C5C5C5C5C5C5C5C5C5C5C3O1C5C5O2
O2O1O1O1C5C5C5C5C5C5C5C3C3C3C5C5C5C5R0O2
O2O2O2O2O2O2O2O2O2C5C5O2O2O2O2O2O2O2O2O2
